MMMMMMMMMMMMMMMMMMMMMMMMMMMMMMMMMMMMMMMMMMMMMMMMMMMMMMMMMMMMMM
MMMMMMMMMMMMMMMMMMMMMMMMMMMMMMMMMMMMMMMMMMMMMMMMMMMMMMMMMMMMMM
MMMMMMMMMMMMMMMMMMMMMMMMMMMMMMMMMMMMMMMMMMMMMMMMMMMMMMMMMMMMMM
MMMMMMMMMMMMMMMMMMMMMMMMNklxXMMMMMMMMMMMMMMMMMMMMMMMMMMMMMMMMM
MMMMMMMMMMMMMMMMMMMMWOl'     .cxWMMMMMMMMMMMMMMMMMMMMMMMMMMMMM
MMMMMMMMMMMMMMMMWOo,            .lXMMMMMMMMMMMMMMMMMMMMMMMMMMM
MMMMMMMMMMMMMMMK'                  ;kWMMMMMMMMMMMMMMMMMMMMMMMM
MMMMMMMMMMMMMMx                      .oNMMMMMMMMMMMMMMMMMMMMMM
MMMMMMMMMMMMN:                          :NMMMMMMMMMMMMMMMMMMMM
MMMMMMMMMMM0.                            .kMMMMMMMMMMMMMMMMMMM
MMMMMMMMMMk                                ;NMMMMMMMMMMMMMMMMM
MMMMMMMMMd                                  .kMMMMMMMMMMMMMMMM
MMMMMMMMl                                     :WMMMMMMMMMMMMMM
MMMMMMN,                                       .OMMMMMMMMMMMMM
MMMMMN.                                          :NMMMMMMMMMMM
MMMMMd:;,..                                       .0MMMMMMMMMM
MMMMMMMMMMMWNX0Oxdlc;,...                           lMMMMMMMMM
MMMMMMMMMMMMMMMMMMMMMMMMMNXKOkxdlc;,'..              .0MMMMMMM
MMMMMMMMMMMMMMMMMMMMMMMMMMMMMMMMMMMMMMMWNK0kxol:;,..   0MMMMMM
MMMMMMMMMMMMMMMMMMMMMMMMMMMMMMMMMMMMMMMMMMMMMMMMMMMMWNXXMMMMMM
MMMMMMMMMMMMMMMMMMMMMMMMMMMMMMMMMMMMMMMMMMMMMMMMMMMMMMMMMMMMMM
MMMMMMMMMMMMMMMMMMMMMMMMMMMMMMMMMMMMMMMMMMMMMMMMMMMMMMMMMMMMMM
MMMMMMMMMMMMMMMMMMMMMMMMMMMMMMMMMMMMMMMMMMMMMMMMMMMMMMMMMMMMMM
