MMMMMMMMMMMMMMMMMMMMMMMMMMMMMMMMMMMMMMMMMMMMMMMMMMMMMMMMMMMMMM
MMMMMMMMMMMMMMMMMMMMMMMMMMMMMMMMMMMMMMMMMMMMMMMMMMMMMMMMMMMMMM
MMMMMMMMMMMMMMMMMMMMMMMMMMMMMMMMMMMMMMMMMMMMMMMMMMMMMMMMMMMMMM
MMMMMMMMMMMMMMMMMMMMMMMMMMMMMMMMMNklxXMMMMMMMMMMMMMMMMMMMMMMMM
MMMMMMMMMMMMMMMMMMMMMMMMMMMMMWkl'     .ckNMMMMMMMMMMMMMMMMMMMM
MMMMMMMMMMMMMMMMMMMMMMMMMMMNo.            'lkWMMMMMMMMMMMMMMMM
MMMMMMMMMMMMMMMMMMMMMMMMMO:                  .OMMMMMMMMMMMMMMM
MMMMMMMMMMMMMMMMMMMMMMWx.                      lMMMMMMMMMMMMMM
MMMMMMMMMMMMMMMMMMMMWl                          'XMMMMMMMMMMMM
MMMMMMMMMMMMMMMMMMM0.                             kMMMMMMMMMMM
MMMMMMMMMMMMMMMMMWl                                oMMMMMMMMMM
MMMMMMMMMMMMMMMM0.                                  cMMMMMMMMM
MMMMMMMMMMMMMMMo                                     ;WMMMMMMM
MMMMMMMMMMMMMK'                                       .XMMMMMM
MMMMMMMMMMMWl                                          .KMMMMM
MMMMMMMMMMX'                                       ..';:oWMMMM
MMMMMMMMMx                            ..,;cloxk0KNWMMMMMMMMMMM
MMMMMMMX;              ..',;cloxkOKXNWMMMMMMMMMMMMMMMMMMMMMMMM
MMMMMMX.  ..';:loxkOKXWMMMMMMMMMMMMMMMMMMMMMMMMMMMMMMMMMMMMMMM
MMMMMMXKNWMMMMMMMMMMMMMMMMMMMMMMMMMMMMMMMMMMMMMMMMMMMMMMMMMMMM
MMMMMMMMMMMMMMMMMMMMMMMMMMMMMMMMMMMMMMMMMMMMMMMMMMMMMMMMMMMMMM
MMMMMMMMMMMMMMMMMMMMMMMMMMMMMMMMMMMMMMMMMMMMMMMMMMMMMMMMMMMMMM
MMMMMMMMMMMMMMMMMMMMMMMMMMMMMMMMMMMMMMMMMMMMMMMMMMMMMMMMMMMMMM
